aa_eleicao;sg_uf;sg_partido;qt_votos_nom_validos;qt_total_vt_leg_validos;qt_votos_validos;qt_eleitoral;80_quociente;quociente_partidario
2022;AC;PMN;119;64;183;54282;43425,6;0,003371283
2022;AC;AGIR;292;31;323;54282;43425,6;0,005950407
2022;AC;CIDADANIA;392;99;491;54282;43425,6;0,009045356
2022;AC;PSC;680;24;704;54282;43425,6;0,012969308
2022;AC;PSOL;802;103;905;54282;43425,6;0,016672193
2022;AC;PROS;925;444;1369;54282;43425,6;0,025220147
2022;AC;PATRIOTA;1151;332;1483;54282;43425,6;0,02732029
2022;AC;PV;2030;62;2092;54282;43425,6;0,038539479
2022;AC;REDE;2901;115;3016;54282;43425,6;0,055561696
2022;AC;SOLIDARIEDADE;3985;362;4347;54282;43425,6;0,080081795
2022;AC;PSB;5816;505;6321;54282;43425,6;0,116447441
2022;AC;PC do B;15054;413;15467;54282;43425,6;0,284937917
2022;AC;PT;18602;1885;20487;54282;43425,6;0,377417929
2022;AC;PODE;20239;830;21069;54282;43425,6;0,388139715
2022;AC;PDT;19583;2273;21856;54282;43425,6;0,402638075
2022;AC;PSD;23485;673;24158;54282;43425,6;0,44504624
2022;AC;PSDB;32696;716;33412;54282;43425,6;0,615526325
2022;AC;MDB;37923;1089;39012;54282;43425,6;0,718691279
2022;AC;REPUBLICANOS;57575;1442;59017;54282;43425,6;1,087229653
2022;AC;UNIÃO;83195;1744;84939;54282;43425,6;1,564772853
2022;AC;PP;91304;2298;93602;54282;43425,6;1,724365351
2022;AL;PRTB;0;38;38;183408;146726,4;0,000207188
2022;AL;PCO;74;15;89;183408;146726,4;0,000485257
2022;AL;PROS;0;121;121;183408;146726,4;0,000659731
2022;AL;DC;173;38;211;183408;146726,4;0,001150441
2022;AL;PC do B;0;230;230;183408;146726,4;0,001254035
2022;AL;REDE;0;272;272;183408;146726,4;0,001483032
2022;AL;PMB;255;128;383;183408;146726,4;0,00208824
2022;AL;PSTU;256;271;527;183408;146726,4;0,002873375
2022;AL;AGIR;538;121;659;183408;146726,4;0,003593082
2022;AL;PMN;772;320;1092;183408;146726,4;0,005953939
2022;AL;SOLIDARIEDADE;1417;448;1865;183408;146726,4;0,010168586
2022;AL;UP;2298;71;2369;183408;146726,4;0,012916558
2022;AL;PATRIOTA;2634;406;3040;183408;146726,4;0,016575068
2022;AL;CIDADANIA;2932;334;3266;183408;146726,4;0,017807293
2022;AL;PSOL;4159;465;4624;183408;146726,4;0,02521155
2022;AL;AVANTE;5197;1521;6718;183408;146726,4;0,036628718
2022;AL;PTB;9620;1118;10738;183408;146726,4;0,058547064
2022;AL;PDT;10385;5633;16018;183408;146726,4;0,08733534
2022;AL;PSDB;42086;1618;43704;183408;146726,4;0,238288406
2022;AL;PSD;77555;1034;78589;183408;146726,4;0,428492759
2022;AL;PT;69519;9583;79102;183408;146726,4;0,431289802
2022;AL;PSB;117029;892;117921;183408;146726,4;0,642943601
2022;AL;REPUBLICANOS;144070;2453;146523;183408;146726,4;0,798890997
2022;AL;PV;152789;2189;154978;183408;146726,4;0,844990404
2022;AL;UNIÃO;167578;3354;170932;183408;146726,4;0,931976795
2022;AL;MDB;245321;15392;260713;183408;146726,4;1,421491974
2022;AL;PP;534588;11453;546041;183408;146726,4;2,977192925
2022;AM;NOVO;0;0;0;247060;197648;0
2022;AM;PODE;31;143;174;247060;197648;0,000704282
2022;AM;AGIR;2187;97;2284;247060;197648;0,009244718
2022;AM;PROS;2214;144;2358;247060;197648;0,00954424
2022;AM;PV;1468;932;2400;247060;197648;0,009714239
2022;AM;PSOL;1634;830;2464;247060;197648;0,009973286
2022;AM;DC;2034;518;2552;247060;197648;0,010329475
2022;AM;PSB;1120;2248;3368;247060;197648;0,013632316
2022;AM;PMN;3954;781;4735;247060;197648;0,019165385
2022;AM;PTB;4698;488;5186;247060;197648;0,020990852
2022;AM;SOLIDARIEDADE;6554;740;7294;247060;197648;0,029523193
2022;AM;PSDB;7797;1709;9506;247060;197648;0,038476483
2022;AM;PSC;6560;5366;11926;247060;197648;0,048271675
2022;AM;PDT;9588;2646;12234;247060;197648;0,049518336
2022;AM;PATRIOTA;12536;1206;13742;247060;197648;0,055622116
2022;AM;REDE;27793;303;28096;247060;197648;0,113721363
2022;AM;MDB;35390;2278;37668;247060;197648;0,152464988
2022;AM;PC do B;36816;979;37795;247060;197648;0,152979033
2022;AM;PT;108788;5879;114667;247060;197648;0,464126123
2022;AM;AVANTE;137099;4523;141622;247060;197648;0,573229175
2022;AM;PL;227086;7402;234488;247060;197648;0,949113576
2022;AM;REPUBLICANOS;287065;4484;291549;247060;197648;1,180073666
2022;AM;CIDADANIA;311831;2392;314223;247060;197648;1,271848944
2022;AM;PSD;317043;6301;323344;247060;197648;1,308767101
2022;AM;UNIÃO;363768;9034;372802;247060;197648;1,508953291
2022;AP;PCO;0;0;0;52877;42301,6;0
2022;AP;AGIR;44;16;60;52877;42301,6;0,001134709
2022;AP;CIDADANIA;0;282;282;52877;42301,6;0,005333132
2022;AP;PRTB;639;165;804;52877;42301,6;0,015205099
2022;AP;PATRIOTA;1136;39;1175;52877;42301,6;0,022221382
2022;AP;AVANTE;1307;203;1510;52877;42301,6;0,028556839
2022;AP;PV;2643;335;2978;52877;42301,6;0,056319383
2022;AP;PSD;5536;573;6109;52877;42301,6;0,115532273
2022;AP;PSOL;10402;156;10558;52877;42301,6;0,199670934
2022;AP;PT;14090;801;14891;52877;42301,6;0,281615825
2022;AP;PSB;15303;329;15632;52877;42301,6;0,29562948
2022;AP;PSC;15819;321;16140;52877;42301,6;0,305236681
2022;AP;PSDB;17172;395;17567;52877;42301,6;0,33222384
2022;AP;PC do B;18281;266;18547;52877;42301,6;0,350757418
2022;AP;REDE;25266;401;25667;52877;42301,6;0,485409535
2022;AP;PODE;26279;522;26801;52877;42301,6;0,506855533
2022;AP;PTB;26937;501;27438;52877;42301,6;0,518902358
2022;AP;REPUBLICANOS;37790;556;38346;52877;42301,6;0,725192428
2022;AP;PP;38443;643;39086;52877;42301,6;0,73918717
2022;AP;MDB;44541;1156;45697;52877;42301,6;0,864213174
2022;AP;PL;47480;1361;48841;52877;42301,6;0,923671918
2022;AP;PDT;63498;1390;64888;52877;42301,6;1,2271498
2022;BA;PCO;0;275;275;204062;163249,6;0,00134763
2022;BA;PRTB;1091;2610;3701;204062;163249,6;0,018136645
2022;BA;UP;3433;610;4043;204062;163249,6;0,019812606
2022;BA;AGIR;3360;1135;4495;204062;163249,6;0,022027619
2022;BA;DC;5479;474;5953;204062;163249,6;0,029172506
2022;BA;PCB;4099;1918;6017;204062;163249,6;0,029486137
2022;BA;PROS;9193;384;9577;204062;163249,6;0,046931815
2022;BA;REDE;9860;1044;10904;204062;163249,6;0,05343474
2022;BA;PMB;11380;564;11944;204062;163249,6;0,058531231
2022;BA;NOVO;9924;2502;12426;204062;163249,6;0,060893258
2022;BA;PATRIOTA;12656;1749;14405;204062;163249,6;0,070591291
2022;BA;PSOL;41906;4850;46756;204062;163249,6;0,229126442
2022;BA;PTB;47884;4252;52136;204062;163249,6;0,255490978
2022;BA;CIDADANIA;54830;3349;58179;204062;163249,6;0,285104527
2022;BA;SOLIDARIEDADE;104754;3384;108138;204062;163249,6;0,529927179
2022;BA;PV;112909;12196;125105;204062;163249,6;0,613073478
2022;BA;PSC;148755;2566;151321;204062;163249,6;0,741544237
2022;BA;PODE;174912;1554;176466;204062;163249,6;0,864766591
2022;BA;PSB;189664;5038;194702;204062;163249,6;0,954131587
2022;BA;PSDB;209086;6794;215880;204062;163249,6;1,057913771
2022;BA;PC do B;252369;13532;265901;204062;163249,6;1,303040252
2022;BA;AVANTE;273978;2510;276488;204062;163249,6;1,354921543
2022;BA;MDB;282950;7032;289982;204062;163249,6;1,421048505
2022;BA;PDT;370527;26360;396887;204062;163249,6;1,944933403
2022;BA;REPUBLICANOS;528661;4632;533293;204062;163249,6;2,613387108
2022;BA;PL;594881;25259;620140;204062;163249,6;3,03897835
2022;BA;PP;757603;19230;776833;204062;163249,6;3,806847919
2022;BA;UNIÃO;1046045;28968;1075013;204062;163249,6;5,268070488
2022;BA;PSD;1085442;56032;1141474;204062;163249,6;5,59376072
2022;BA;PT;1257507;112490;1369997;204062;163249,6;6,713631151
2022;CE;NOVO;0;0;0;232193;185754,4;0
2022;CE;PCO;128;687;815;232193;185754,4;0,003510011
2022;CE;UP;2140;187;2327;232193;185754,4;0,010021835
2022;CE;PMB;2439;307;2746;232193;185754,4;0,011826369
2022;CE;AGIR;2386;644;3030;232193;185754,4;0,013049489
2022;CE;PROS;3385;337;3722;232193;185754,4;0,016029768
2022;CE;PATRIOTA;4195;356;4551;232193;185754,4;0,019600074
2022;CE;REDE;4172;381;4553;232193;185754,4;0,019608688
2022;CE;PCB;3579;2073;5652;232193;185754,4;0,024341819
2022;CE;PV;4265;1403;5668;232193;185754,4;0,024410727
2022;CE;PODE;5171;530;5701;232193;185754,4;0,02455285
2022;CE;PTB;5296;1518;6814;232193;185754,4;0,029346277
2022;CE;PMN;7185;3876;11061;232193;185754,4;0,047637095
2022;CE;PSC;11476;424;11900;232193;185754,4;0,051250468
2022;CE;CIDADANIA;19513;3986;23499;232193;185754,4;0,101204601
2022;CE;PSDB;28895;2181;31076;232193;185754,4;0,133836937
2022;CE;AVANTE;33354;3446;36800;232193;185754,4;0,158488843
2022;CE;PC do B;48183;2984;51167;232193;185754,4;0,220364094
2022;CE;PSOL;121635;3244;124879;232193;185754,4;0,537824138
2022;CE;PSB;167841;1637;169478;232193;185754,4;0,729901418
2022;CE;REPUBLICANOS;176939;2432;179371;232193;185754,4;0,772508215
2022;CE;PP;216275;9188;225463;232193;185754,4;0,971015491
2022;CE;MDB;254306;5239;259545;232193;185754,4;1,117798556
2022;CE;PT;496927;65530;562457;232193;185754,4;2,422368461
2022;CE;PSD;615006;6803;621809;232193;185754,4;2,677983402
2022;CE;UNIÃO;709596;10205;719801;232193;185754,4;3,100011628
2022;CE;PDT;932593;42814;975407;232193;185754,4;4,200845848
2022;CE;PL;1042535;16412;1058947;232193;185754,4;4,560632749
2022;DF;PSTU;304;137;441;200940;160752;0,002194685
2022;DF;PCO;473;73;546;200940;160752;0,002717229
2022;DF;PRTB;419;355;774;200940;160752;0,003851896
2022;DF;UP;1472;87;1559;200940;160752;0,007758535
2022;DF;PATRIOTA;3008;755;3763;200940;160752;0,018726983
2022;DF;DC;3709;107;3816;200940;160752;0,018990744
2022;DF;CIDADANIA;3314;946;4260;200940;160752;0,021200358
2022;DF;PTB;3759;789;4548;200940;160752;0,022633622
2022;DF;SOLIDARIEDADE;4700;261;4961;200940;160752;0,024688962
2022;DF;PSDB;4505;1040;5545;200940;160752;0,027595302
2022;DF;PROS;5278;487;5765;200940;160752;0,028690156
2022;DF;REDE;5395;396;5791;200940;160752;0,028819548
2022;DF;PC do B;6328;197;6525;200940;160752;0,03247238
2022;DF;PSC;6222;1058;7280;200940;160752;0,03622972
2022;DF;PMN;6793;752;7545;200940;160752;0,037548522
2022;DF;AGIR;6089;1713;7802;200940;160752;0,038827511
2022;DF;PDT;6160;3353;9513;200940;160752;0,04734249
2022;DF;PODE;8882;634;9516;200940;160752;0,04735742
2022;DF;AVANTE;10990;830;11820;200940;160752;0,058823529
2022;DF;NOVO;25110;2841;27951;200940;160752;0,139101224
2022;DF;PSOL;44535;1763;46298;200940;160752;0,230407087
2022;DF;PV;55359;1229;56588;200940;160752;0,281616403
2022;DF;PSD;69247;2223;71470;200940;160752;0,355678312
2022;DF;UNIÃO;80343;1931;82274;200940;160752;0,409445606
2022;DF;PP;114899;2654;117553;200940;160752;0,585015427
2022;DF;PSB;135257;1539;136796;200940;160752;0,680780332
2022;DF;MDB;157812;4313;162125;200940;160752;0,806832885
2022;DF;PT;211054;16837;227891;200940;160752;1,134124614
2022;DF;PL;264740;10756;275496;200940;160752;1,37103613
2022;DF;REPUBLICANOS;297339;3968;301307;200940;160752;1,499487409
2022;ES;AGIR;176;286;462;208443;166754,4;0,002216433
2022;ES;PROS;0;534;534;208443;166754,4;0,002561851
2022;ES;PV;656;462;1118;208443;166754,4;0,005363577
2022;ES;PMB;1083;308;1391;208443;166754,4;0,006673287
2022;ES;CIDADANIA;715;998;1713;208443;166754,4;0,008218074
2022;ES;PRTB;1862;161;2023;208443;166754,4;0,009705291
2022;ES;DC;1557;513;2070;208443;166754,4;0,009930772
2022;ES;PSD;1660;984;2644;208443;166754,4;0,012684523
2022;ES;AVANTE;2976;169;3145;208443;166754,4;0,015088058
2022;ES;SOLIDARIEDADE;2220;1413;3633;208443;166754,4;0,017429225
2022;ES;PC do B;7531;484;8015;208443;166754,4;0,038451759
2022;ES;NOVO;8221;598;8819;208443;166754,4;0,042308929
2022;ES;PSOL;12501;1296;13797;208443;166754,4;0,066190757
2022;ES;REDE;20405;1334;21739;208443;166754,4;0,104292301
2022;ES;PATRIOTA;73856;1433;75289;208443;166754,4;0,361197066
2022;ES;PSDB;93379;2253;95632;208443;166754,4;0,458792092
2022;ES;PSC;121721;2029;123750;208443;166754,4;0,593687483
2022;ES;UNIÃO;121374;2573;123947;208443;166754,4;0,594632585
2022;ES;PDT;120573;5140;125713;208443;166754,4;0,603104926
2022;ES;PTB;150750;2841;153591;208443;166754,4;0,736848923
2022;ES;PODE;191380;2619;193999;208443;166754,4;0,930705277
2022;ES;PSB;187962;6577;194539;208443;166754,4;0,933295913
2022;ES;REPUBLICANOS;194016;6901;200917;208443;166754,4;0,963894206
2022;ES;PT;193704;14950;208654;208443;166754,4;1,001012267
2022;ES;PL;207005;13990;220995;208443;166754,4;1,060217901
2022;ES;PP;291375;4926;296301;208443;166754,4;1,421496524
2022;GO;PV;825;330;1155;202322;161857,6;0,005708722
2022;GO;PCB;1403;1002;2405;202322;161857,6;0,011886992
2022;GO;REDE;2732;341;3073;202322;161857,6;0,01518866
2022;GO;CIDADANIA;2792;1083;3875;202322;161857,6;0,019152638
2022;GO;PC do B;2809;1859;4668;202322;161857,6;0,023072133
2022;GO;DC;4960;623;5583;202322;161857,6;0,027594626
2022;GO;PSOL;4854;1512;6366;202322;161857,6;0,031464695
2022;GO;PMN;6541;858;7399;202322;161857,6;0,036570417
2022;GO;AGIR;10177;1890;12067;202322;161857,6;0,05964255
2022;GO;PODE;19301;1343;20644;202322;161857,6;0,102035369
2022;GO;NOVO;21967;1624;23591;202322;161857,6;0,116601259
2022;GO;PTB;27071;1382;28453;202322;161857,6;0,140632259
2022;GO;PROS;31736;342;32078;202322;161857,6;0,158549243
2022;GO;AVANTE;57750;1656;59406;202322;161857,6;0,293621059
2022;GO;PRTB;61966;3841;65807;202322;161857,6;0,325258746
2022;GO;PSB;77221;1738;78959;202322;161857,6;0,390264035
2022;GO;SOLIDARIEDADE;133116;1909;135025;202322;161857,6;0,667376756
2022;GO;PATRIOTA;146247;2864;149111;202322;161857,6;0,736998448
2022;GO;PSDB;172618;5793;178411;202322;161857,6;0,881817103
2022;GO;PDT;172557;8000;180557;202322;161857,6;0,892423958
2022;GO;PSD;177565;3056;180621;202322;161857,6;0,892740285
2022;GO;PSC;182445;3847;186292;202322;161857,6;0,920769862
2022;GO;REPUBLICANOS;268377;5065;273442;202322;161857,6;1,351518866
2022;GO;MDB;265386;11922;277308;202322;161857,6;1,37062702
2022;GO;PT;263139;23805;286944;202322;161857,6;1,41825407
2022;GO;PP;281377;6393;287770;202322;161857,6;1,422336671
2022;GO;UNIÃO;359305;14554;373859;202322;161857,6;1,847841559
2022;GO;PL;556679;18096;574775;202322;161857,6;2,840892241
2022;MA;PCO;63;150;213;205917;164733,6;0,001034397
2022;MA;PCB;0;1182;1182;205917;164733,6;0,005740177
2022;MA;REDE;1095;498;1593;205917;164733,6;0,007736127
2022;MA;PMB;1333;358;1691;205917;164733,6;0,008212047
2022;MA;PRTB;1358;665;2023;205917;164733,6;0,009824347
2022;MA;SOLIDARIEDADE;1837;360;2197;205917;164733,6;0,010669347
2022;MA;DC;2109;206;2315;205917;164733,6;0,011242394
2022;MA;PSTU;1607;1212;2819;205917;164733,6;0,013689982
2022;MA;PSDB;212;3237;3449;205917;164733,6;0,016749467
2022;MA;PTB;763;3934;4697;205917;164733,6;0,022810161
2022;MA;PV;3916;890;4806;205917;164733,6;0,023339501
2022;MA;PSOL;5053;764;5817;205917;164733,6;0,028249246
2022;MA;NOVO;6335;420;6755;205917;164733,6;0,032804479
2022;MA;AGIR;6922;609;7531;205917;164733,6;0,036572988
2022;MA;PROS;7562;507;8069;205917;164733,6;0,039185691
2022;MA;AVANTE;5671;2491;8162;205917;164733,6;0,03963733
2022;MA;CIDADANIA;60888;2178;63066;205917;164733,6;0,306269031
2022;MA;PC do B;170675;7573;178248;205917;164733,6;0,865630327
2022;MA;PDT;168246;15141;183387;205917;164733,6;0,890586984
2022;MA;REPUBLICANOS;185325;4499;189824;205917;164733,6;0,921847152
2022;MA;PODE;219133;3842;222975;205917;164733,6;1,082839202
2022;MA;PT;206230;18068;224298;205917;164733,6;1,089264121
2022;MA;PSD;227388;3524;230912;205917;164733,6;1,121383859
2022;MA;PATRIOTA;227458;4178;231636;205917;164733,6;1,124899838
2022;MA;PSC;232082;3479;235561;205917;164733,6;1,143960916
2022;MA;PSB;259251;17761;277012;205917;164733,6;1,345260469
2022;MA;MDB;295049;6534;301583;205917;164733,6;1,464585246
2022;MA;PP;298238;6196;304434;205917;164733,6;1,47843063
2022;MA;UNIÃO;369041;5163;374204;205917;164733,6;1,817256467
2022;MA;PL;614792;11247;626039;205917;164733,6;3,040249227
2022;MG;PCO;363;371;734;210964;168771,2;0,003479267
2022;MG;PMB;719;2315;3034;210964;168771,2;0,014381601
2022;MG;UP;3302;1221;4523;210964;168771,2;0,021439677
2022;MG;PSTU;3005;1546;4551;210964;168771,2;0,021572401
2022;MG;DC;415;4393;4808;210964;168771,2;0,022790618
2022;MG;AGIR;5422;1115;6537;210964;168771,2;0,030986329
2022;MG;PRTB;18912;529;19441;210964;168771,2;0,092153164
2022;MG;PCB;28156;3358;31514;210964;168771,2;0,149380937
2022;MG;PC do B;36441;3217;39658;210964;168771,2;0,18798468
2022;MG;CIDADANIA;74467;3919;78386;210964;168771,2;0,371561025
2022;MG;PMN;82659;2279;84938;210964;168771,2;0,402618456
2022;MG;REDE;103129;4216;107345;210964;168771,2;0,508830891
2022;MG;PSB;105851;4447;110298;210964;168771,2;0,522828539
2022;MG;PTB;121624;3710;125334;210964;168771,2;0,594101363
2022;MG;PV;151910;8264;160174;210964;168771,2;0,759248023
2022;MG;SOLIDARIEDADE;178969;2608;181577;210964;168771,2;0,860701352
2022;MG;NOVO;159159;25940;185099;210964;168771,2;0,877396143
2022;MG;PROS;184875;1110;185985;210964;168771,2;0,881595912
2022;MG;PSOL;197879;7036;204915;210964;168771,2;0,971326861
2022;MG;PSC;246499;12389;258888;210964;168771,2;1,22716672
2022;MG;PSDB;306576;7521;314097;210964;168771,2;1,488865399
2022;MG;PODE;306867;32110;338977;210964;168771,2;1,606800212
2022;MG;REPUBLICANOS;367503;4436;371939;210964;168771,2;1,76304488
2022;MG;MDB;394321;8717;403038;210964;168771,2;1,910458656
2022;MG;PDT;402407;23226;425633;210964;168771,2;2,017562238
2022;MG;PATRIOTA;540018;3183;543201;210964;168771,2;2,574851633
2022;MG;PP;638033;17425;655458;210964;168771,2;3,106966117
2022;MG;UNIÃO;664086;4990;669076;210964;168771,2;3,171517415
2022;MG;PSD;731720;34909;766629;210964;168771,2;3,633932804
2022;MG;AVANTE;920014;4194;924208;210964;168771,2;4,38088015
2022;MG;PT;1472542;115151;1587693;210964;168771,2;7,525895413
2022;MG;PL;2339512;43898;2383410;210964;168771,2;11,29770956
2022;MS;DC;495;33;528;171851;137480,8;0,003072429
2022;MS;CIDADANIA;0;536;536;171851;137480,8;0,003118981
2022;MS;AGIR;682;141;823;171851;137480,8;0,004789032
2022;MS;REDE;1103;262;1365;171851;137480,8;0,007942927
2022;MS;PC do B;1370;116;1486;171851;137480,8;0,008647026
2022;MS;PV;1580;289;1869;171851;137480,8;0,0108757
2022;MS;PROS;2175;89;2264;171851;137480,8;0,013174203
2022;MS;PSOL;5147;659;5806;171851;137480,8;0,033785081
2022;MS;NOVO;6461;722;7183;171851;137480,8;0,041797836
2022;MS;PSB;7484;1115;8599;171851;137480,8;0,050037533
2022;MS;SOLIDARIEDADE;8886;333;9219;171851;137480,8;0,053645309
2022;MS;PDT;8685;3881;12566;171851;137480,8;0,073121483
2022;MS;PRTB;21109;1026;22135;171851;137480,8;0,12880344
2022;MS;AVANTE;23439;190;23629;171851;137480,8;0,137497018
2022;MS;PTB;28668;1370;30038;171851;137480,8;0,174790953
2022;MS;UNIÃO;60289;3065;63354;171851;137480,8;0,368656569
2022;MS;PODE;62375;1601;63976;171851;137480,8;0,372275983
2022;MS;REPUBLICANOS;73699;1575;75274;171851;137480,8;0,438018982
2022;MS;MDB;73672;3942;77614;171851;137480,8;0,451635428
2022;MS;PSD;79985;2599;82584;171851;137480,8;0,48055583
2022;MS;PP;141534;5072;146606;171851;137480,8;0,853099487
2022;MS;PT;182462;19499;201961;171851;137480,8;1,17520992
2022;MS;PL;210788;7639;218427;171851;137480,8;1,271025481
2022;MS;PSDB;310946;6020;316966;171851;137480,8;1,844423367
2022;MT;REDE;1031;130;1161;216285;173028;0,005367917
2022;MT;AGIR;1337;171;1508;216285;173028;0,006972282
2022;MT;DC;2580;131;2711;216285;173028;0,012534387
2022;MT;PC do B;3722;249;3971;216285;173028;0,018360034
2022;MT;SOLIDARIEDADE;4364;166;4530;216285;173028;0,020944587
2022;MT;PP;0;4593;4593;216285;173028;0,021235869
2022;MT;NOVO;4060;553;4613;216285;173028;0,02132834
2022;MT;PV;6501;693;7194;216285;173028;0,033261669
2022;MT;PODE;9562;824;10386;216285;173028;0,048019974
2022;MT;PATRIOTA;9942;702;10644;216285;173028;0,049212844
2022;MT;PDT;6533;4175;10708;216285;173028;0,04950875
2022;MT;PROS;12340;180;12520;216285;173028;0,057886585
2022;MT;CIDADANIA;13593;1584;15177;216285;173028;0,070171302
2022;MT;PSOL;18793;840;19633;216285;173028;0,090773748
2022;MT;PSDB;28637;2407;31044;216285;173028;0,143532839
2022;MT;PTB;98740;2694;101434;216285;173028;0,468983055
2022;MT;PSD;129842;4416;134258;216285;173028;0,620745775
2022;MT;PT;137885;10816;148701;216285;173028;0,687523407
2022;MT;PSB;146286;4248;150534;216285;173028;0,695998336
2022;MT;REPUBLICANOS;152741;2772;155513;216285;173028;0,719018887
2022;MT;UNIÃO;241542;7786;249328;216285;173028;1,152775273
2022;MT;MDB;266777;5882;272659;216285;173028;1,260646832
2022;MT;PL;366945;10512;377457;216285;173028;1,745183439
2022;PA;PATRIOTA;81;1416;1497;265972;212777,6;0,005628412
2022;PA;PMB;1296;344;1640;265972;212777,6;0,006166063
2022;PA;PSTU;628;1090;1718;265972;212777,6;0,006459327
2022;PA;PROS;1611;245;1856;265972;212777,6;0,006978178
2022;PA;PV;2202;327;2529;265972;212777,6;0,00950852
2022;PA;AGIR;2538;289;2827;265972;212777,6;0,010628938
2022;PA;AVANTE;1241;4077;5318;265972;212777,6;0,019994586
2022;PA;PRTB;6499;352;6851;265972;212777,6;0,025758351
2022;PA;REDE;6693;661;7354;265972;212777,6;0,027649527
2022;PA;SOLIDARIEDADE;10038;443;10481;265972;212777,6;0,039406404
2022;PA;PC do B;14777;1055;15832;265972;212777,6;0,059525063
2022;PA;CIDADANIA;22739;2233;24972;265972;212777,6;0,093889582
2022;PA;PSC;65206;1635;66841;265972;212777,6;0,251308408
2022;PA;PODE;66808;2411;69219;265972;212777,6;0,260249199
2022;PA;PSOL;146421;2688;149109;265972;212777,6;0,560619163
2022;PA;PDT;137812;13053;150865;265972;212777,6;0,567221362
2022;PA;REPUBLICANOS;164561;3895;168456;265972;212777,6;0,633359903
2022;PA;PSDB;169843;6049;175892;265972;212777,6;0,661317733
2022;PA;PP;178285;9000;187285;265972;212777,6;0,704153069
2022;PA;PSB;188493;1915;190408;265972;212777,6;0,715894906
2022;PA;PTB;202983;3349;206332;265972;212777,6;0,77576587
2022;PA;UNIÃO;297721;3878;301599;265972;212777,6;1,13395019
2022;PA;PSD;345289;5495;350784;265972;212777,6;1,318875671
2022;PA;PT;337562;25287;362849;265972;212777,6;1,364237589
2022;PA;PL;523763;16235;539998;265972;212777,6;2,030281383
2022;PA;MDB;1488451;30553;1519004;265972;212777,6;5,711142526
2022;PB;PCO;0;170;170;183995;147196;0,000923938
2022;PB;DC;46;289;335;183995;147196;0,001820702
2022;PB;PROS;305;143;448;183995;147196;0,002434849
2022;PB;PMB;451;137;588;183995;147196;0,003195739
2022;PB;AGIR;686;319;1005;183995;147196;0,005462105
2022;PB;PV;977;271;1248;183995;147196;0,006782793
2022;PB;CIDADANIA;0;1419;1419;183995;147196;0,007712166
2022;PB;PODE;1195;385;1580;183995;147196;0,00858719
2022;PB;PATRIOTA;1684;189;1873;183995;147196;0,010179624
2022;PB;UP;3409;98;3507;183995;147196;0,019060301
2022;PB;PC do B;3778;486;4264;183995;147196;0,023174543
2022;PB;AVANTE;4488;413;4901;183995;147196;0,026636593
2022;PB;PSOL;5419;818;6237;183995;147196;0,03389766
2022;PB;PSDB;5216;4917;10133;183995;147196;0,055072149
2022;PB;PTB;9587;1515;11102;183995;147196;0,060338596
2022;PB;REDE;10717;1371;12088;183995;147196;0,065697437
2022;PB;SOLIDARIEDADE;12199;885;13084;183995;147196;0,071110628
2022;PB;PDT;6007;9030;15037;183995;147196;0,081725047
2022;PB;PRTB;15936;1055;16991;183995;147196;0,092344901
2022;PB;MDB;66449;4112;70561;183995;147196;0,383494117
2022;PB;PT;169955;18895;188850;183995;147196;1,026386587
2022;PB;UNIÃO;197700;5664;203364;183995;147196;1,105269165
2022;PB;PSB;227661;8018;235679;183995;147196;1,280898937
2022;PB;PL;273385;9887;283272;183995;147196;1,539563575
2022;PB;PSC;311874;2725;314599;183995;147196;1,709823637
2022;PB;PP;319458;7561;327019;183995;147196;1,777325471
2022;PB;REPUBLICANOS;470449;8132;478581;183995;147196;2,601054376
2022;PE;PMB;27;381;408;198795;159036;0,002052366
2022;PE;PSTU;883;990;1873;198795;159036;0,009421766
2022;PE;DC;2927;213;3140;198795;159036;0,015795166
2022;PE;UP;3178;198;3376;198795;159036;0,016982318
2022;PE;AGIR;3041;568;3609;198795;159036;0,01815438
2022;PE;PCB;2847;1026;3873;198795;159036;0,019482381
2022;PE;PTB;2913;2685;5598;198795;159036;0,028159662
2022;PE;PSC;5228;948;6176;198795;159036;0,03106718
2022;PE;PSD;3276;2970;6246;198795;159036;0,031419301
2022;PE;PMN;9383;697;10080;198795;159036;0,050705501
2022;PE;NOVO;11851;1096;12947;198795;159036;0,065127393
2022;PE;PATRIOTA;14526;1596;16122;198795;159036;0,081098619
2022;PE;PSDB;22596;5230;27826;198795;159036;0,139973339
2022;PE;PRTB;50896;246;51142;198795;159036;0,257259991
2022;PE;PC do B;61260;2594;63854;198795;159036;0,321205262
2022;PE;CIDADANIA;110652;3469;114121;198795;159036;0,574063734
2022;PE;PSOL;112653;2409;115062;198795;159036;0,578797253
2022;PE;PV;113348;3130;116478;198795;159036;0,585920169
2022;PE;PDT;126894;13490;140384;198795;159036;0,706174703
2022;PE;REDE;150365;1447;151812;198795;159036;0,763661058
2022;PE;PODE;154551;1833;156384;198795;159036;0,786659624
2022;PE;SOLIDARIEDADE;188043;8719;196762;198795;159036;0,989773385
2022;PE;AVANTE;222903;2197;225100;198795;159036;1,132322242
2022;PE;MDB;255972;3504;259476;198795;159036;1,305244096
2022;PE;PT;302519;53083;355602;198795;159036;1,788787444
2022;PE;REPUBLICANOS;409779;6280;416059;198795;159036;2,092904751
2022;PE;UNIÃO;450624;10807;461431;198795;159036;2,321139868
2022;PE;PL;616536;19695;636231;198795;159036;3,200437637
2022;PE;PP;668988;12176;681164;198795;159036;3,426464448
2022;PE;PSB;698808;28719;727527;198795;159036;3,6596846
2022;PI;PCO;54;38;92;195748;156598,4;0,000469992
2022;PI;PSTU;361;200;561;195748;156598,4;0,00286593
2022;PI;AGIR;350;213;563;195748;156598,4;0,002876147
2022;PI;REDE;518;230;748;195748;156598,4;0,00382124
2022;PI;PC do B;0;849;849;195748;156598,4;0,004337209
2022;PI;UP;878;72;950;195748;156598,4;0,004853179
2022;PI;PSDB;0;1033;1033;195748;156598,4;0,005277193
2022;PI;PCB;770;451;1221;195748;156598,4;0,006237612
2022;PI;PMN;2339;900;3239;195748;156598,4;0,016546785
2022;PI;PATRIOTA;2362;1210;3572;195748;156598,4;0,018247951
2022;PI;PTB;3498;969;4467;195748;156598,4;0,022820157
2022;PI;CIDADANIA;5566;510;6076;195748;156598,4;0,031039908
2022;PI;PSOL;5915;603;6518;195748;156598,4;0,033297914
2022;PI;NOVO;8091;350;8441;195748;156598,4;0,043121769
2022;PI;PODE;12010;228;12238;195748;156598,4;0,062519157
2022;PI;PDT;14924;12222;27146;195748;156598,4;0,138678301
2022;PI;PL;27726;3176;30902;195748;156598,4;0,157866236
2022;PI;UNIÃO;75736;1845;77581;195748;156598,4;0,396330997
2022;PI;PV;83770;1063;84833;195748;156598,4;0,43337863
2022;PI;SOLIDARIEDADE;90175;2508;92683;195748;156598,4;0,473481211
2022;PI;REPUBLICANOS;99291;3199;102490;195748;156598,4;0,523581339
2022;PI;PP;384179;16739;400918;195748;156598,4;2,048133314
2022;PI;PSD;421342;5626;426968;195748;156598,4;2,181212579
2022;PI;PT;627637;35757;663394;195748;156598,4;3,389020577
2022;PR;PCO;0;187;187;201288;161030,4;0,000929017
2022;PR;PSTU;214;558;772;201288;161030,4;0,003835301
2022;PR;PRTB;2775;198;2973;201288;161030,4;0,014769882
2022;PR;PMN;4373;735;5108;201288;161030,4;0,025376575
2022;PR;PCB;5101;1179;6280;201288;161030,4;0,031199078
2022;PR;PC do B;7724;544;8268;201288;161030,4;0,041075474
2022;PR;PATRIOTA;8658;1020;9678;201288;161030,4;0,048080362
2022;PR;PMB;12489;835;13324;201288;161030,4;0,066193712
2022;PR;AGIR;13462;679;14141;201288;161030,4;0,070252573
2022;PR;PSOL;12652;3949;16601;201288;161030,4;0,082473868
2022;PR;REDE;25474;766;26240;201288;161030,4;0,130360479
2022;PR;DC;30688;411;31099;201288;161030,4;0,15450002
2022;PR;PSC;32211;870;33081;201288;161030,4;0,164346608
2022;PR;PTB;45505;1928;47433;201288;161030,4;0,235647431
2022;PR;NOVO;61883;6409;68292;201288;161030,4;0,339275069
2022;PR;PSDB;83360;4770;88130;201288;161030,4;0,437830372
2022;PR;CIDADANIA;86645;2685;89330;201288;161030,4;0,44379198
2022;PR;PDT;80036;10608;90644;201288;161030,4;0,45031994
2022;PR;PV;98413;4250;102663;201288;161030,4;0,510030404
2022;PR;SOLIDARIEDADE;132964;1321;134285;201288;161030,4;0,667128691
2022;PR;PSB;174150;9340;183490;201288;161030,4;0,911579428
2022;PR;PROS;211637;2399;214036;201288;161030,4;1,063332141
2022;PR;MDB;267995;5689;273684;201288;161030,4;1,359663765
2022;PR;REPUBLICANOS;291210;4087;295297;201288;161030,4;1,46703728
2022;PR;PODE;423806;6185;429991;201288;161030,4;2,136197886
2022;PR;PL;555423;37737;593160;201288;161030,4;2,946822463
2022;PR;UNIÃO;627997;13878;641875;201288;161030,4;3,188838878
2022;PR;PP;694656;9519;704175;201288;161030,4;3,498345654
2022;PR;PT;803602;58819;862421;201288;161030,4;4,284512738
2022;PR;PSD;1033798;18186;1051984;201288;161030,4;5,226262867
2022;RJ;PSTU;924;1282;2206;186435;149148;0,011832542
2022;RJ;PCB;5256;2940;8196;186435;149148;0,043961702
2022;RJ;DC;16484;981;17465;186435;149148;0,093678762
2022;RJ;PMB;21211;753;21964;186435;149148;0,117810497
2022;RJ;PV;27761;1989;29750;186435;149148;0,159573042
2022;RJ;PRTB;35140;1085;36225;186435;149148;0,194303645
2022;RJ;PSC;36415;1799;38214;186435;149148;0,204972242
2022;RJ;REDE;38916;1495;40411;186435;149148;0,21675651
2022;RJ;AGIR;52347;1507;53854;186435;149148;0,28886207
2022;RJ;PSDB;75416;3890;79306;186435;149148;0,4253815
2022;RJ;NOVO;60594;21141;81735;186435;149148;0,43841017
2022;RJ;CIDADANIA;85115;2619;87734;186435;149148;0,470587604
2022;RJ;PATRIOTA;88343;3067;91410;186435;149148;0,490304932
2022;RJ;PMN;94054;1856;95910;186435;149148;0,514442031
2022;RJ;PC do B;123289;2009;125298;186435;149148;0,672073377
2022;RJ;AVANTE;130655;1130;131785;186435;149148;0,706868346
2022;RJ;PTB;169852;7395;177247;186435;149148;0,950717408
2022;RJ;PSB;203537;10598;214135;186435;149148;1,148577252
2022;RJ;SOLIDARIEDADE;210394;4047;214441;186435;149148;1,150218575
2022;RJ;PDT;207533;25185;232718;186435;149148;1,248252742
2022;RJ;PROS;241999;1890;243889;186435;149148;1,308171749
2022;RJ;PODE;264996;2671;267667;186435;149148;1,435712179
2022;RJ;MDB;407744;6762;414506;186435;149148;2,223327165
2022;RJ;REPUBLICANOS;490610;3720;494330;186435;149148;2,651487113
2022;RJ;PP;562915;6135;569050;186435;149148;3,052270228
2022;RJ;PSD;680378;8877;689255;186435;149148;3,697025773
2022;RJ;PSOL;685731;12189;697920;186435;149148;3,743503098
2022;RJ;PT;643267;91245;734512;186435;149148;3,939775257
2022;RJ;UNIÃO;957401;10152;967553;186435;149148;5,189760506
2022;RJ;PL;1627468;89834;1717302;186435;149148;9,211263979
2022;RN;PSTU;620;203;823;233103;186482,4;0,003530628
2022;RN;PRTB;968;317;1285;233103;186482,4;0,005512585
2022;RN;PMB;1462;554;2016;233103;186482,4;0,008648537
2022;RN;DC;1962;132;2094;233103;186482,4;0,008983153
2022;RN;PMN;1837;477;2314;233103;186482,4;0,009926942
2022;RN;PATRIOTA;3304;284;3588;233103;186482,4;0,015392337
2022;RN;PTB;3173;719;3892;233103;186482,4;0,016696482
2022;RN;CIDADANIA;3642;673;4315;233103;186482,4;0,01851113
2022;RN;PC do B;4394;495;4889;233103;186482,4;0,020973561
2022;RN;AVANTE;6391;2525;8916;233103;186482,4;0,038249186
2022;RN;PODE;13544;498;14042;233103;186482,4;0,060239465
2022;RN;PSC;14377;196;14573;233103;186482,4;0,062517428
2022;RN;PV;14512;3353;17865;233103;186482,4;0,07663994
2022;RN;PDT;12646;9758;22404;233103;186482,4;0,096112019
2022;RN;PSD;25684;906;26590;233103;186482,4;0,114069746
2022;RN;PSDB;41218;10370;51588;233103;186482,4;0,221309893
2022;RN;PSB;98109;2430;100539;233103;186482,4;0,43130719
2022;RN;REPUBLICANOS;102791;1149;103940;233103;186482,4;0,445897307
2022;RN;PP;148476;4585;153061;233103;186482,4;0,656623896
2022;RN;SOLIDARIEDADE;165881;3675;169556;233103;186482,4;0,727386606
2022;RN;MDB;173515;3012;176527;233103;186482,4;0,757291841
2022;RN;PT;276901;17052;293953;233103;186482,4;1,261043401
2022;RN;UNIÃO;311950;3640;315590;233103;186482,4;1,35386503
2022;RN;PL;360769;9696;370465;233103;186482,4;1,589275985
2022;RO;REDE;0;135;135;108643;86914,4;0,001242602
2022;RO;PMB;110;239;349;108643;86914,4;0,003212356
2022;RO;PSOL;676;139;815;108643;86914,4;0,007501634
2022;RO;PV;799;80;879;108643;86914,4;0,008090719
2022;RO;AGIR;1462;58;1520;108643;86914,4;0,013990777
2022;RO;PC do B;2120;64;2184;108643;86914,4;0,020102538
2022;RO;PROS;2146;112;2258;108643;86914,4;0,020783668
2022;RO;SOLIDARIEDADE;2043;270;2313;108643;86914,4;0,021289913
2022;RO;PATRIOTA;4834;1581;6415;108643;86914,4;0,059046602
2022;RO;PDT;7991;1812;9803;108643;86914,4;0,090231308
2022;RO;PTB;13028;1185;14213;108643;86914,4;0,130822971
2022;RO;PP;17808;1431;19239;108643;86914,4;0,17708458
2022;RO;AVANTE;21507;829;22336;108643;86914,4;0,205590788
2022;RO;PSB;34592;1135;35727;108643;86914,4;0,328847694
2022;RO;PT;39777;3809;43586;108643;86914,4;0,401185534
2022;RO;PSC;56908;937;57845;108643;86914,4;0,53243191
2022;RO;REPUBLICANOS;66653;1631;68284;108643;86914,4;0,628517254
2022;RO;PSD;70094;2036;72130;108643;86914,4;0,663917602
2022;RO;PODE;76514;993;77507;108643;86914,4;0,713409976
2022;RO;MDB;92320;1428;93748;108643;86914,4;0,862899589
2022;RO;PL;137683;5010;142693;108643;86914,4;1,313411817
2022;RO;UNIÃO;191125;4044;195169;108643;86914,4;1,796424988
2022;RR;PC do B;0;15;15;36464;29171,2;0,000411365
2022;RR;PSDB;39;90;129;36464;29171,2;0,003537736
2022;RR;PV;538;26;564;36464;29171,2;0,01546731
2022;RR;PSC;287;283;570;36464;29171,2;0,015631856
2022;RR;DC;689;5;694;36464;29171,2;0,01903247
2022;RR;PSOL;609;86;695;36464;29171,2;0,019059895
2022;RR;PATRIOTA;670;40;710;36464;29171,2;0,019471259
2022;RR;PRTB;448;264;712;36464;29171,2;0,019526108
2022;RR;CIDADANIA;649;108;757;36464;29171,2;0,020760202
2022;RR;PDT;849;423;1272;36464;29171,2;0,034883721
2022;RR;PTB;1226;64;1290;36464;29171,2;0,035377358
2022;RR;SOLIDARIEDADE;1255;43;1298;36464;29171,2;0,035596753
2022;RR;PMB;1221;358;1579;36464;29171,2;0,043302984
2022;RR;PT;2199;314;2513;36464;29171,2;0,068917288
2022;RR;PMN;3046;146;3192;36464;29171,2;0,087538394
2022;RR;PROS;4362;199;4561;36464;29171,2;0,125082273
2022;RR;REDE;12895;151;13046;36464;29171,2;0,357777534
2022;RR;PODE;15891;310;16201;36464;29171,2;0,444301229
2022;RR;PP;24415;974;25389;36464;29171,2;0,696275779
2022;RR;PL;26576;637;27213;36464;29171,2;0,746297718
2022;RR;PSD;29693;275;29968;36464;29171,2;0,821851689
2022;RR;UNIÃO;41463;368;41831;36464;29171,2;1,147186266
2022;RR;MDB;48417;869;49286;36464;29171,2;1,351634489
2022;RR;REPUBLICANOS;67215;1014;68229;36464;29171,2;1,871133172
2022;RS;AGIR;106;319;425;198381;158704,8;0,002142342
2022;RS;DC;1039;148;1187;198381;158704,8;0,005983436
2022;RS;PROS;778;486;1264;198381;158704,8;0,006371578
2022;RS;PSTU;1070;772;1842;198381;158704,8;0,009285163
2022;RS;UP;1910;176;2086;198381;158704,8;0,01051512
2022;RS;PRTB;2550;106;2656;198381;158704,8;0,013388379
2022;RS;PCB;2570;1091;3661;198381;158704,8;0,018454388
2022;RS;REDE;7159;759;7918;198381;158704,8;0,039913097
2022;RS;SOLIDARIEDADE;11809;786;12595;198381;158704,8;0,063488943
2022;RS;PV;17245;884;18129;198381;158704,8;0,09138476
2022;RS;PATRIOTA;27807;709;28516;198381;158704,8;0,143743604
2022;RS;PSC;28190;1156;29346;198381;158704,8;0,147927473
2022;RS;AVANTE;39341;435;39776;198381;158704,8;0,200503072
2022;RS;PTB;87418;2348;89766;198381;158704,8;0,45249293
2022;RS;PC do B;107764;1510;109274;198381;158704,8;0,55082896
2022;RS;CIDADANIA;124930;3521;128451;198381;158704,8;0,647496484
2022;RS;PSB;190350;2850;193200;198381;158704,8;0,973883588
2022;RS;UNIÃO;211942;3425;215367;198381;158704,8;1,085623119
2022;RS;PSOL;290989;4273;295262;198381;158704,8;1,48835826
2022;RS;PSD;288762;6595;295357;198381;158704,8;1,488837137
2022;RS;NOVO;295450;6516;301966;198381;158704,8;1,522151819
2022;RS;PODE;316517;2333;318850;198381;158704,8;1,607260776
2022;RS;PDT;301905;19412;321317;198381;158704,8;1,619696443
2022;RS;PSDB;340387;12157;352544;198381;158704,8;1,77710567
2022;RS;PP;508102;14193;522295;198381;158704,8;2,632787414
2022;RS;REPUBLICANOS;542183;7347;549530;198381;158704,8;2,770073747
2022;RS;MDB;575864;10461;586325;198381;158704,8;2,955550179
2022;RS;PL;556912;123280;680192;198381;158704,8;3,428715452
2022;RS;PT;945565;95160;1040725;198381;158704,8;5,246092116
2022;SC;PSTU;424;648;1072;248115;198492;0,004320577
2022;SC;DC;891;599;1490;248115;198492;0,00600528
2022;SC;REDE;1482;445;1927;248115;198492;0,00776656
2022;SC;PRTB;2138;365;2503;248115;198492;0,010088064
2022;SC;UP;3370;178;3548;248115;198492;0,014299821
2022;SC;PV;3320;334;3654;248115;198492;0,014727042
2022;SC;PROS;4381;298;4679;248115;198492;0,018858191
2022;SC;SOLIDARIEDADE;10184;771;10955;248115;198492;0,044152913
2022;SC;AVANTE;12211;298;12509;248115;198492;0,050416138
2022;SC;PDT;22893;8403;31296;248115;198492;0,126135058
2022;SC;PSC;34953;867;35820;248115;198492;0,144368539
2022;SC;PC do B;38976;892;39868;248115;198492;0,160683554
2022;SC;PSOL;57014;3879;60893;248115;198492;0,245422486
2022;SC;PTB;59403;3306;62709;248115;198492;0,252741672
2022;SC;PSB;60290;3195;63485;248115;198492;0,255869254
2022;SC;PATRIOTA;70421;1248;71669;248115;198492;0,288853959
2022;SC;REPUBLICANOS;116962;3532;120494;248115;198492;0,485637708
2022;SC;CIDADANIA;133142;2226;135368;248115;198492;0,545585716
2022;SC;PSDB;133800;4607;138407;248115;198492;0,557834069
2022;SC;PODE;181671;3783;185454;248115;198492;0,747451786
2022;SC;PP;202589;6729;209318;248115;198492;0,843632993
2022;SC;NOVO;235491;8177;243668;248115;198492;0,98207686
2022;SC;UNIÃO;273109;6323;279432;248115;198492;1,126219697
2022;SC;PSD;384542;6887;391429;248115;198492;1,577611188
2022;SC;MDB;405130;10107;415237;248115;198492;1,673566693
2022;SC;PT;440101;40810;480911;248115;198492;1,938258469
2022;SC;PL;923157;38896;962053;248115;198492;3,877447958
2022;SE;REDE;543;207;750;148952;119161,6;0,005035179
2022;SE;PC do B;809;176;985;148952;119161,6;0,006612869
2022;SE;PROS;1655;77;1732;148952;119161,6;0,011627907
2022;SE;SOLIDARIEDADE;1613;357;1970;148952;119161,6;0,013225737
2022;SE;UP;2088;68;2156;148952;119161,6;0,014474462
2022;SE;PV;1240;1640;2880;148952;119161,6;0,019335088
2022;SE;DC;3401;161;3562;148952;119161,6;0,023913744
2022;SE;PTB;3477;396;3873;148952;119161,6;0,026001665
2022;SE;PATRIOTA;3761;404;4165;148952;119161,6;0,027962028
2022;SE;MDB;3664;628;4292;148952;119161,6;0,028814652
2022;SE;PMN;3609;710;4319;148952;119161,6;0,028995918
2022;SE;PODE;5188;874;6062;148952;119161,6;0,040697674
2022;SE;PSDB;7077;775;7852;148952;119161,6;0,052714969
2022;SE;CIDADANIA;12564;1532;14096;148952;119161,6;0,094634513
2022;SE;PSB;14966;2297;17263;148952;119161,6;0,115896396
2022;SE;PSOL;23097;1176;24273;148952;119161,6;0,162958537
2022;SE;PDT;53261;4206;57467;148952;119161,6;0,385808851
2022;SE;PP;131367;4633;136000;148952;119161,6;0,913045813
2022;SE;PL;137347;6163;143510;148952;119161,6;0,96346474
2022;SE;PT;139855;11589;151444;148952;119161,6;1,016730222
2022;SE;REPUBLICANOS;159749;4009;163758;148952;119161,6;1,099401149
2022;SE;PSD;194852;5081;199933;148952;119161,6;1,342264622
2022;SE;UNIÃO;235914;3361;239275;148952;119161,6;1,606389978
2022;SP;PCO;2443;1744;4187;332778;266222,4;0,012581962
2022;SP;DC;4166;1103;5269;332778;266222,4;0,015833378
2022;SP;PSTU;6222;2568;8790;332778;266222,4;0,026414006
2022;SP;PMN;13899;1564;15463;332778;266222,4;0,046466413
2022;SP;PCB;10469;5041;15510;332778;266222,4;0,046607648
2022;SP;PMB;16849;1849;18698;332778;266222,4;0,056187609
2022;SP;UP;21017;3125;24142;332778;266222,4;0,072546863
2022;SP;AGIR;32124;1219;33343;332778;266222,4;0,100195926
2022;SP;PV;40395;5399;45794;332778;266222,4;0,13761126
2022;SP;PRTB;51357;2167;53524;332778;266222,4;0,160839959
2022;SP;PROS;59292;1284;60576;332778;266222,4;0,182031264
2022;SP;PC do B;139151;6576;145727;332778;266222,4;0,437910559
2022;SP;PTB;213420;3792;217212;332778;266222,4;0,652723437
2022;SP;PATRIOTA;226790;2157;228947;332778;266222,4;0,687987187
2022;SP;AVANTE;240446;1368;241814;332778;266222,4;0,726652603
2022;SP;PDT;247738;38160;285898;332778;266222,4;0,859125303
2022;SP;PSC;287793;5399;293192;332778;266222,4;0,881043819
2022;SP;REDE;300904;3676;304580;332778;266222,4;0,915264831
2022;SP;NOVO;299156;62112;361268;332778;266222,4;1,085612631
2022;SP;SOLIDARIEDADE;375909;3401;379310;332778;266222,4;1,139828955
2022;SP;CIDADANIA;426412;12162;438574;332778;266222,4;1,317917651
2022;SP;PSB;705638;27503;733141;332778;266222,4;2,203093354
2022;SP;PODE;885799;6644;892443;332778;266222,4;2,681796874
2022;SP;PSD;1044282;11683;1055965;332778;266222,4;3,17318152
2022;SP;PSDB;1003926;57612;1061538;332778;266222,4;3,189928421
2022;SP;PP;1165107;9539;1174646;332778;266222,4;3,529818678
2022;SP;MDB;1494557;38984;1533541;332778;266222,4;4,608300429
2022;SP;REPUBLICANOS;1563793;17098;1580891;332778;266222,4;4,750587479
2022;SP;UNIÃO;1802437;9025;1811462;332778;266222,4;5,443454796
2022;SP;PSOL;1963591;20690;1984281;332778;266222,4;5,962776986
2022;SP;PT;2550352;390734;2941086;332778;266222,4;8,837982078
2022;SP;PL;5133998;209669;5343667;332778;266222,4;16,05775322
2022;TO;PRTB;634;129;763;103767;83013,6;0,007353012
2022;TO;DC;790;69;859;103767;83013,6;0,008278162
2022;TO;PV;841;346;1187;103767;83013,6;0,011439089
2022;TO;PMB;1174;126;1300;103767;83013,6;0,012528068
2022;TO;REDE;903;430;1333;103767;83013,6;0,012846088
2022;TO;PC do B;1320;407;1727;103767;83013,6;0,016643056
2022;TO;PSOL;1507;255;1762;103767;83013,6;0,01698035
2022;TO;CIDADANIA;1136;804;1940;103767;83013,6;0,018695732
2022;TO;PATRIOTA;6154;214;6368;103767;83013,6;0,061368258
2022;TO;AVANTE;6034;521;6555;103767;83013,6;0,063170372
2022;TO;PDT;3667;3082;6749;103767;83013,6;0,065039945
2022;TO;PSB;13773;953;14726;103767;83013,6;0,141914096
2022;TO;PSDB;17412;982;18394;103767;83013,6;0,177262521
2022;TO;PTB;26243;868;27111;103767;83013,6;0,261268033
2022;TO;PSD;30823;1923;32746;103767;83013,6;0,315572388
2022;TO;MDB;46649;1030;47679;103767;83013,6;0,459481338
2022;TO;PSC;49990;669;50659;103767;83013,6;0,488199524
2022;TO;PT;61149;5960;67109;103767;83013,6;0,646727765
2022;TO;PODE;71684;628;72312;103767;83013,6;0,696868947
2022;TO;PP;87144;2475;89619;103767;83013,6;0,863656076
2022;TO;PL;86730;3897;90627;103767;83013,6;0,873370147
2022;TO;UNIÃO;102346;2029;104375;103767;83013,6;1,005859281
2022;TO;REPUBLICANOS;179490;4750;184240;103767;83013,6;1,775516301